red: 0,A
++++++++++
+       a+
+  +++++++
+  A    0+
+        +
+        +
+        +
+        +
+        +
++++++++++
