red: 0,A,B,C,D
++++++++++
+    dcba+
+  +++++++
+  D    0+
+  C     +
+  B     +
+  A     +
+        +
+        +
++++++++++
