red: 0,M,A,S,X
+++++++++++++
+       masx+
+    ++++++++
+  M       0+
+  A        +
+  S        +
+  X        +
+           +
+++++++++++++
