red: 0,A,B,C,D,E,F
+++++++++++++++
+A           a+
+B           b+
+C           c+
+D           d+
+E           e+
+F           f+
+             +
+             +
+             +
+             +
+             +
+             +
+            0+
+++++++++++++++