red: 0,A,B,C,D,E,F,G,H,I,J
+++++++++++++++
+A           a+
+B           b+
+C           c+
+D           d+
+E           e+
+F           f+
+G           g+
+H           h+
+I           i+
+J           j+
+             +
+             +
+            0+
+++++++++++++++