red: 0,A,B,C
+++++++++++++++
+A           a+
+B           b+
+C           c+
+             +
+             +
+             +
+             +
+             +
+             +
+             +
+             +
+             +
+            0+
+++++++++++++++