red: 0,A
green: 1,B
++++++++++++++++++++++++++++
+       b    0  B1     Aa  +
+ +++++++++++++++++++ ++++++
+                          +
++++++++++++++++++++++++++++
