red: 1,A
green: 0,B
++++++++++++++++++++++++++++
+       b   A1  B0      a  +
+ +++++++++++++++++++ ++++++
+                          +
++++++++++++++++++++++++++++
