red: 0,A
green: 1,B
blue: 2, 3
++++++++++++++++++++++++++++
+    2  b    0  B1 3   Aa  +
+ +++++++++++++++++++ ++++++
+                          +
++++++++++++++++++++++++++++
