+++++++++++
+0A       +
+AA       +
+         +
+         +
+         +
+         +
+         +
+         +
+       +a+
+       +A+
+++++++++++
