red: 0,A
green: 1,B
++++++++++++++
+1 A  0   Bb +
+++++++ ++++++
+            +
++++++++++++++
