red: 0,A
green: 1,B
blue: 2,C
++++++++++++++++++
+1 A 0  C 2   Bb +
+++++++++++ ++++++
+                +
++++++++++++++++++
