red: 0,A,1,B,6
green:2,7
yellow: 3,4,5, C
++++++++++++++++++++++++++++
+     b    1    0A B2C  a  +
+                  ++3     +
++++++++++++++++++++++++++++
+     d    5    4E D7C  e  +
+                  ++6     +
++++++++++++++++++++++++++++