red: 0,A,1
++++++++++++++++++++++++++++
+                      a   +
+  0                    A  +
++++++++++++++++++++++++++++
+                       1  +
+                          +
++++++++++++++++++++++++++++
