red: 0,A,D,E,F
green: 1,B,C,G,H
++++++++++++++++++++++++++++
+h    d    F  0G       Aa E+
+     1                Bb  +
+ +++++++++++++++++        +
+   cC          D     ef gH+
++++++++++++++++++++++++++++
