green: 0,A,B,C
++++++++++++++++++++++++++++
+                          +
+     0                Bb  +
+ +++++++++++++++++        +
+   Aa                 cC  +
++++++++++++++++++++++++++++
