red: 0,A,D
green: 1,B,C
++++++++++++++++++++++++++++
+D            0        Aa  +
+     1                Bb  +
+ +++++++++++++++++        +
+   cC                  d  +
++++++++++++++++++++++++++++
