red: 0,A
green: 1,B,C
++++++++++++++++++++++++++++
+             0        Aa  +
+     1                Bb  +
+ +++++++++++++++++        +
+   cC                     +
++++++++++++++++++++++++++++
