red: 0,A,B,C,D
++++++++++++
+0 B       +
+++++b++++ +
+A  a C    +
+     c    +
+    Dd    +
++++++++++++
