red: 0,M,A,S,X
+++++++++++++
+m          +
+++++++++   +
+M          +
+          M+
+           +
+           +
+0          +
+++++++++++++
