red: 0,1,A
+++++++++
+aA   Aa+
+aA   Aa+
+aA   Aa+
+aA   Aa+
+aA 1 Aa+
+       +
+aA 0 Aa+
+aA   Aa+
+aA   Aa+
+aA   Aa+
+aA   Aa+
+++++++++
