red: 0,1,2,3,4,A
+++++++++
+aA   Aa+
+aA   Aa+
+aA   Aa+
+aA   Aa+
+aA2 3Aa+
+   4   +
+aA0 1Aa+
+aA   Aa+
+aA   Aa+
+aA   Aa+
+aA   Aa+
+++++++++
