red: 0,A
+++++++++
+aA   Aa+
+aA   Aa+
+aA   Aa+
+aA   Aa+
+aA   Aa+
+   0   +
+aA   Aa+
+aA   Aa+
+aA   Aa+
+aA   Aa+
+aA   Aa+
+++++++++
