red: 0,A,B
++++++++++
+      ba+
+  +++++++
+  B    0+
+  A     +
+        +
+        +
+        +
+        +
++++++++++
