red: 0,A,B,C,D,E
++++++++++
+   edcba+
+ ++++++++
+ +E    0+
+ +D     +
+ +C     +
+ +B     +
+ +A     +
+        +
++++++++++
