red: 0,A,B,C
++++++++
+   cba+
+ ++++++
+ +C  0+
+ +B   +
+ +A   +
+      +
++++++++
